3 1 4 6 5 8 7 9 2 
5 2 9 3 7 1 4 6 8 
6 8 7 4 2 9 5 3 1 
4 6 3 5 1 2 9 8 7 
9 7 2 8 6 3 1 4 5 
8 5 1 7 9 4 6 2 3 
1 3 8 9 4 7 2 5 6 
2 9 6 1 3 5 8 7 4 
7 4 5 2 8 6 3 1 9 

3 1 4 6 5 8 7 9 2 
5 2 9 3 7 1 4 6 8 
6 8 7 9 2 4 5 3 1 
4 6 3 5 1 2 9 8 7 
9 7 2 8 6 3 1 4 5 
8 5 1 4 9 7 6 2 3 
1 3 8 7 4 9 2 5 6 
2 9 6 1 3 5 8 7 4 
7 4 5 2 8 6 3 1 9 

2
